#################
#-EE--####--EEEE#
#$$##-#$#$------#
#$###-#$#$---$$-#
#####-#$#$--$$$$#
#$$$$-#$#$#-$$$$#
#$$$$-------#$$##
##$$##$#-#$##$$##
##$$##$#-#$######
#$####$#-#$#####$
#$####$#-#$#####$
#$$###$#-#$####$$