##########------#
#-########-EEEE-#
#-##$$##$#------#
#-##$$##$#--#####
#-##$$##$#--#$$$#
#-##$$##$#--#$$$#
#--#$$##$#--#$$$#
##-#######--#####
##----####--#####
#$###-####--###$#
#$$##-------##$$#
#################