#################
#-EE--#######-E-#
#$$---#######-E-#
#$$##-#$$$$$$-E-#
#$$##-#$$$$$$-E-#
$$$$#-#######---#
$$$$#-#####-----#
#$$##-#$$##-#####
#####-$$$$#-#####
#$###-#$$##-##$$#
#$$##-------##$$#
#################